                                                                                                                                    .
                                                                                                                                    .
                                                                                                                                    .
                                                                                                                                    .
                                                                                                                                    .
                                                                                                                                    .
                                                        `;|$@##########@&%!'.                                                       .
                                                .!&#########@&$%||||%%$@#########@|'                                                .
                                           .|@#########%:.               ``.   '!&#####$'                                           .
                                       .|########$:         .               !##############$'                                       .
                                    `$###|`                         :;   :;;&#################@;                                    .
                                 .%##&:   '$%`        .!@####%'        '||$@$&###################&:                                 .
                               ;@#&'               '$###&@###&|$%%@#################################|                               .
                             !##!              !####@;'&##############################################$`                            .
                           |#@:         ;&:   ;|$###!`%#################################################$`                          .
                         !#@:       `%|;%'   '|!&&' `!$###################################################$`                        .
                       :@#;          :@#|.'%@##$!||$########################################################|                       .
                     .$#%.           `;&#####################################################################@:                     .
                    ;@#;           '&#######################################################################&@#|                    .
                   |#&'       .'. `$########################################################################$;%#$`                  .
                 .%#$`       ;@#####&&@%&#!!###########$&#@%%########@!;$#####################################$$#&'                 .
                .%#%.       %####$`     :@| ;########!   .. ;######$` .|#######################################@@#@:                .
               .%#$`       .%##$`    ':  `$%.:@#####;         '&####;  `$##########################################@'               .
               |#&'        ;;  `:`        .. :@&' !#########&$@######%.  ;##########################################&`              .
              !#@:      '&###########%.      .%$` !##################|   :@##########################################%.             .
             '&#!      :@###########$`             `||%#@@############&:`!############################################!             .
             |#$`   `$###############@!.                 :@########################################################$$#&'            .
            :@#!   !###################@:  !##|.        `$#########################################################!:&#!            .
            |#&'  %###############################$$@&||@#########################################################%..|#$`           .
           `$#|  '&##################################################|`|##########################################;..;##;           .
           :@#;  !####################################@;;############$` `$################################%%######&' '&#|           .
           !#@: :@#####################################! ;#############!      `!%$$|:` :@###############|   '&######;`$#%.          .
           |#&' |#######################################; :@############&;:%##%`          |############%.    '%&####%'%#$`          .
           |#&' !#######################################@: '&###################&'           :@#######$`        |###|`%#$`          .
           |#&' '&#######################################$` !##################%.             |######$`         '' ``.%#$`          .
           !#@: .$#######################################@;  `$###############|               '&####%.          .`   `$#%.          .
           ;##;  :#########################################|  .%###########$'                  `$###$`           :;  '&#|           .
           '&#|   !#########################################%. :@#######&'                      '&##$`            |! !##;           .
            |#$`    '%########################################&!$##@|`                           '&#!.         `$||!.|#&'           .
            ;##;          '&###################################@:      ..                           .%|          |#!'&#|            .
            .%#$`          .|@##########################################|                                        `$$$#@'            .
             :@#!             ;########################################%                                          '%@#!             .
              !#&'            ;#######################################|                                           .%#$`             .
              .%#$`           !#####################################@;                                            !#&'              .
               `$#%            |##################################&:                                             ;##;               .
                '&#|            :@#############################@;                                               ;##;                .
                 `$#%            ;###########################@;                                                ;##;                 .
                  .%#$`           !#########################!                                                 !#@'                  .
                    !#@:          .%#######################%.                                               .%#$.                   .
                     '&#|         '&#######################&'                                              :@#!                     .
                       !#&'       '&########################&'                                           .%#$`                      .
                        .%#%.      '&########################!       .:`                                !#@:                        .
                          `$#%.      ;#######################;     '$##!                              !#@:                          .
                            `$#&'     '&#################!       %####!                            .%#@:                            .
                              .%##|.    |###############|       `$###!                           ;@#&'                              .
                                 :@##|.   ;###########@|'       `$##;                         :@##|                                 .
                                    !@##$'  ;@#######@:                                   .|###%.                                   .
                                       :&###&;                                        '%####!.                                      .
                                           ;&####@|'                            `!&#####|.                                          .
                                               .;&########&%!;:''```':;!%$@#######@|`                                               .
                                                      `:|&################&%;'                                                      .
                                                                                                                                    .
                                                                                                                                    .
                                                                                                                                    .
                                                                                                                                    .
                                                                                                                                    .
